0  0  0  0  0  0  0  0  0  0  0  0  0 0 0 0 0 0 0 0 0 0 0 0 0 0  0  0  0  0  0  0  0  0  0  0  0  0  0  0  0  0  0  0  0  0  0  0  0  0  0  0 0 0 0  0 0  0 0  0  0 0 0  0  0  0  0  0  0  0  0  0  0  0  0  0  0  0  0  0  0  0  0  0  0  0  0  0  0  0  0  0  0  0  0  0  0  0  0  0  0  0  0  0  0  0  0  0  0  0  0  0  0  0  0  0  0  0  0 0 0 0 0 0 0 0 0 0 0 0 0 0 0 0 0 0
0  0  0  0  0  0  0  0  0  0  0  0  0 0 0 0 0 0 0 0 0 0 0 0 0 0  0  0  0  0  0  0  0  0  0  0  0  0  0  0  0  0  0  0  0  0  0  0  0  0  0  0 0 0 0  0 0  0 0  0  0 0 0  0  0  0  0  0  0  0  0  0  0  0  0  0  0  0  0  0  0  0  0  0  0  0  0  0  0  0  0  0  0  0  0  0  0  0  0  0  0  0  0  0  0  0  0  0  0  0  0  0  0  0  0  0  0  0  0 0 0 0 0 0 0 0 0 0 0 0 0 0 0 0 0 0
0  0  0  0  0  0  0  0  0  0  0  0  0 0 0 0 0 0 0 0 0 0 0 0 0 0  0  0  0  0  0  0  0  0  0  0  0  0  0  0  0  0  0  0  0  0  0  0  0  0  0  0 0 0 0  0 0  0 0  0  0 0 0  0  0  0  0  0  0  0  0  0  0  0  0  0  0  0  0  0  0  0  0  0  0  0  0  0  0  0  0  0  0  0  0  0  0  0  0  0  0  0  0  0  0  0  0  0  0  0  0  0  0  0  0  0  0  0  0 0 0 0 0 0 0 0 0 0 0 0 0 0 0 0 0 0
0  0  0  0  0  0  0  0  0  0  0  0  0 0 0 0 0 0 0 0 0 0 0 0 0 0  0  0  0  0  0  0  0  0  0  0  0  0  0  0  0  0  0  0  0  0  0  0  0  0  0  0 0 0 0  0 0  0 0  0  0 0 0  0  0  0  0  0  0  0  0  0  0  0  0  0  0  0  0  0  0  0  0  0  0  0  0  0  0  0  0  0  0  0  0  0  0  0  0  0  0  0  0  0  0  0  0  0  0  0  0  0  0  0  0  0  0  0  0 0 0 0 0 0 0 0 0 0 0 0 0 0 0 0 0 0
0  0  0  0  0  0  0  0  0  0  0  0  0 0 0 0 0 0 0 0 0 0 0 0 0 0  0  0  0  0  0  0  0  0  0  0  0  0  0  0  0  0  0  0  0  0  0  0  0  0  0  0 0 0 0  0 0  0 0  0  0 0 0  0  0  0  0  0  0  0  0  0  0  0  0  0  0  0  0  0  0  0  0  0  0  0  0  0  0  0  0  0  0  0  0  0  0  0  0  0  0  0  0  0  0  0  0  0  0  0  0  0  0  0  0  0  0  0  0 0 0 0 0 0 0 0 0 0 0 0 0 0 0 0 0 0
0  0  0  0  0  0  0  0  0  0  0  0  0 0 0 0 0 0 0 0 0 0 0 0 0 0  0  0  0  0  0  0  0  0  0  0  0  0  0  0  0  0  0  0  0  0  0  0  0  0  0  0 0 0 0  0 0  0 0  0  0 0 0  0  0  0  0  0  0  0  0  0  0  0  0  0  0  0  0  0  0  0  0  0  0  0  0  0  0  0  0  0  0  0  0  0  0  0  0  0  0  0  0  0  0  0  0  0  0  0  0  0  0  0  0  0  0  0  0 0 0 0 0 0 0 0 0 0 0 0 0 0 0 0 0 0
0  0  0  0  0  0  0  0  0  0  0  0  0 0 0 0 0 0 0 0 0 0 0 0 0 0  0  0  0  0  0  0  0  0  0  0  0  0  0  0  0  0  0  0  0  0  0  0  0  0  0  0 0 0 0  0 0  0 0  0  0 0 0  0  0  0  0  0  0  0  0  0  0  0  0  0  0  0  0  0  0  0  0  0  0  0  0  0  0  0  0  0  0  0  0  0  0  0  0  0  0  0  0  0  0  0  0  0  0  0  0  0  0  0  0  0  0  0  0 0 0 0 0 0 0 0 0 0 0 0 0 0 0 0 0 0
0  0  0  0  0  0  0  0  0  0  0  0  0 0 0 0 0 0 0 0 0 0 0 0 0 0  0  0  0  0  0  0  0  0  0  0  0  0  0  0  0  0  0  0  0  0  0  0  0  0  0  0 0 0 0  0 0  0 0  0  0 0 0  0  0  0  0  0  0  0  0  0  0  0  0  0  0  0  0  0  0  0  0  0  0  0  0  0  0  0  0  0  0  0  0  0  0  0  0  0  0  0  0  0  0  0  0  0  0  0  0  0  0  0  0  0  0  0  0 0 0 0 0 0 0 0 0 0 0 0 0 0 0 0 0 0
0  0  0  0  0  0  0  0  0  0  0  0  0 0 0 0 0 0 0 0 0 0 0 0 0 0  0  0  0  0  0  0  0  0  0  0  0  0  0  0  0  0  0  0  0  0  0  0  0  0  0  0 0 0 0  0 0  0 0  0  0 0 0  0  0  0  0  0  0  0  0  0  0  0  0  0  0  0  0  0  0  0  0  0  0  0  0  0  0  0  0  0  0  0  0  0  0  0  0  0  0  0  0  0  0  0  0  0  0  0  0  0  0  0  0  0  0  0  0 0 0 0 0 0 0 0 0 0 0 0 0 0 0 0 0 0
0  0  0  0  0  0  0  0  0  0  0  0  0 0 0 0 0 0 0 0 0 0 0 0 0 0  0  0  0  0  0  0  0  0  0  0  0  0  0  0  0  0  0  0  0  0  0  0  0  0  0  0 0 0 0  0 0  0 0  0  0 0 0  0  0  0  0  0  0  0  0  0  0  0  0  0  0  0  0  0  0  0  0  0  0  0  0  0  0  0  0  0  0  0  0  0  0  0  0  0  0  0  0  0  0  0  0  0  0  0  0  0  0  0  0  0  0  0  0 0 0 0 0 0 0 0 0 0 0 0 0 0 0 0 0 0
0  0  0  0  0  0  0  0  0  0  0  0  0 0 0 0 0 0 0 0 0 0 0 0 0 0  0  0  0  0  0  0  0  0  0  0  0  0  0  0  0  0  0  0  0  0  0  0  0  0  0  0 0 0 0  0 0  0 0  0  0 0 0  0  0  0  0  0  0  0  0  0  0  0  0  5  2  6  0  0  0  0  0  0  0  0  0  0  0  0  0  0  0  0  0  0  0  0  0  0  0  0  0  0  0  0  0  0  0  0  0  0  0  0  0  0  0  0  0 0 0 0 0 0 0 0 0 0 0 0 0 0 0 0 0 0
0  0  0  0  0  0  0  0  0  0  0  0  0 0 0 0 0 0 0 0 0 0 0 0 0 0  0  0  0  0  0  0  0  0  0  0  0  0  0  0  0  0  0  0  0  0  0  0  0  0  0  0 0 0 0  0 0  0 0  0  0 0 0  0  0  0  0  0  0  0  0  0  0  0  0  4  1  7  0  0  0  0  0  0  0  0  0  0  0  0  0  0  0  0  0  0  0  0  0  0  0  0  0  0  0  0  0  0  0  99 0  99 0  99 0  0  0  0  0 0 0 0 0 0 0 0 0 0 0 0 0 0 0 0 0 0
0  0  0  0  0  0  0  0  0  0  0  0  0 0 0 0 0 0 0 0 0 0 0 0 0 0  0  0  0  0  0  0  0  0  0  0  0  0  0  0  0  0  0  0  0  0  0  0  0  0  0  0 0 0 0  0 0  0 0  0  0 0 0  0  0  0  0  0  0  0  0  0  0  99 0  4  1  7  0  0  0  0  0  0  0  0  0  0  0  0  0  0  0  0  0  0  0  0  0  0  0  0  0  0  0  0  0  0  0  0  0  0  0  0  0  0  0  0  0 0 0 0 0 0 0 88 0 0 0 0 0 0 0 0 0 0
0  0  0  0  0  0  0  0  0  0  0  0  0 0 0 0 0 0 0 0 0 0 0 0 0 0  0  0  0  0  0  0  0  0  0  0  0  0  0  0  0  0  0  0  0  0  0  0  0  0  0  0 0 0 0  0 0  0 0  0  0 0 0  0  0  0  0  0  0  0  0  0  0  0  0  4  1  7  0  0  0  0  0  0  0  0  0  0  0  0  0  0  0  0  0  0  0  0  0  0  0  0  0  5  2  2  2  2  2  2  2  2  2  2  2  2  2  2  2 2 2 2 2 2 2 2 2 2 2 2 2 2 2 2 2 2
0  0  0  0  0  0  0  0  0  0  0  0  0 0 0 0 0 0 0 0 0 0 0 0 0 0  0  0  0  0  0  0  0  0  0  0  0  0  0  0  0  0  0  0  0  0  0  0  0  0  0  0 0 0 0  0 0  0 0  0  0 0 0  0  0  0  0  0  0  0  0  0  0  99 0  4  1  7  0  0  0  0  0  0  0  0  0  0  0  0  0  0  0  0  0  0  0  0  0  99 0  0  0  4  1  1  1  1  1  1  1  1  1  1  1  1  1  1  1 1 1 1 1 1 1 1 1 1 1 1 1 1 1 1 1 1
0  0  0  0  0  0  0  0  0  0  0  0  0 0 0 0 0 0 0 0 0 0 0 0 0 0  0  0  0  0  0  0  0  0  0  0  0  0  0  0  0  0  0  0  0  0  0  0  0  0  0  0 0 0 0  0 0  0 0  0  0 0 0  0  0  0  0  0  0  0  0  0  0  0  0  4  1  7  0  0  0  0  0  0  0  0  0  0  0  0  0  0  0  0  0  0  0  0  0  0  0  0  0  4  1  1  1  1  1  1  1  1  1  1  1  1  1  1  1 1 1 1 1 1 1 1 1 1 1 1 1 1 1 1 1 1
0  0  0  0  0  0  0  0  0  0  0  0  0 0 0 0 0 0 0 0 0 0 0 0 0 0  0  0  0  99 0  99 0  99 0  0  0  0  0  0  0  0  0  0  0  0  0  0  0  0  0  0 0 0 0  0 0  0 0  99 0 0 0  0  0  0  0  0  0  0  0  99 0  99 0  4  1  7  0  0  0  0  0  0  0  0  0  0  0  0  0  0  0  0  0  0  0  0  3  3  3  0  0  4  1  1  1  1  1  1  1  1  1  1  1  1  1  1  1 1 1 1 1 1 1 1 1 1 1 1 1 1 1 1 1 1
0  0  0  0  88 0  0  0  0  0  0  0  0 0 0 0 0 0 0 0 0 0 0 0 0 0  0  0  0  0  0  0  0  0  0  0  0  0  0  0  0  0  0  0  0  0  0  0  0  0  0  0 0 0 0  0 0  0 0  0  0 0 0  0  0  0  0  0  0  0  0  0  0  0  0  4  1  7  0  0  0  0  0  0  0  0  0  0  0  0  0  0  0  0  0  0  0  0  0  0  0  0  0  4  1  1  1  1  1  1  1  1  1  1  1  1  1  1  1 1 1 1 1 1 1 1 1 1 1 1 1 1 1 1 1 1
2  2  2  2  2  2  2  2  2  2  2  2  2 2 2 2 2 2 2 2 2 2 2 2 2 2  2  2  2  2  2  2  2  2  2  2  2  2  2  2  2  2  2  2  2  6  0  0  0  0  0  0 0 0 99 0 0  0 0  0  0 0 5  2  2  2  2  2  2  2  2  2  2  2  2  8  1  7  0  0  0  0  0  0  0  0  0  0  0  0  0  0  0  0  0  0  0  0  0  0  0  0  0  4  1  1  1  1  1  1  1  1  1  1  1  1  1  1  1 1 1 1 1 1 1 1 1 1 1 1 1 1 1 1 1 1
1  1  1  1  1  1  1  1  1  1  1  1  1 1 1 1 1 1 1 1 1 1 1 1 1 1  1  1  1  1  1  1  1  1  1  1  1  1  1  1  1  1  1  1  1  7  0  0  0  0  0  0 0 0 0  0 0  0 0  0  0 0 4  1  1  1  1  1  1  1  1  1  1  1  1  1  1  7  0  0  0  0  0  0  0  0  0  0  0  0  0  0  3  3  3  0  0  0  0  0  0  0  0  4  1  1  1  1  1  1  1  1  1  1  1  1  1  1  1 1 1 1 1 1 1 1 1 1 1 1 1 1 1 1 1 1
1  1  1  1  1  1  1  1  1  1  1  1  1 1 1 1 1 1 1 1 1 1 1 1 1 1  1  1  1  1  1  1  1  1  1  1  1  1  1  1  1  1  1  1  1  7  0  0  0  0  0  0 0 3 3  3 0  0 0  0  0 0 4  1  14 12 12 12 12 12 12 12 12 12 12 12 12 10 0  0  0  0  0  0  0  99 0  0  0  0  0  0  0  0  0  0  0  0  0  0  0  0  0  4  1  1  1  1  1  1  1  1  1  1  1  1  1  1  1 1 1 1 1 1 1 1 1 1 1 1 1 1 1 1 1 1
1  1  1  1  1  1  1  1  1  1  1  1  1 1 1 1 1 1 1 1 1 1 1 1 1 14 12 12 12 12 12 12 12 12 12 12 12 12 12 12 12 12 12 12 12 10 0  0  0  0  0  0 0 0 0  0 0  0 0  0  0 0 4  1  7  0  0  0  0  0  0  0  0  0  0  0  0  0  0  0  0  0  0  0  0  0  0  0  0  0  0  0  0  0  0  0  0  0  0  0  0  0  0  4  1  1  1  1  1  1  1  1  1  1  1  1  1  1  1 1 1 1 1 1 1 1 1 1 1 1 1 1 1 1 1 1
1  1  1  1  1  1  1  1  1  1  1  1  1 1 1 1 1 1 1 1 1 1 1 1 1 7  0  0  0  0  0  0  0  0  0  0  0  0  0  0  0  0  0  0  0  0  0  0  0  0  0  0 0 0 0  0 0  0 0  0  0 0 4  1  7  0  0  0  0  0  0  0  0  0  0  0  0  0  0  0  0  0  0  0  3  3  3  0  0  0  0  0  0  0  0  0  0  0  0  0  0  0  0  4  1  1  1  1  1  1  1  1  1  1  1  1  1  1  1 1 1 1 1 1 1 1 1 1 1 1 1 1 1 1 1 1
1  1  1  1  1  1  1  1  1  1  1  1  1 1 1 1 1 1 1 1 1 1 1 1 1 7  0  0  0  0  0  0  0  0  0  0  0  0  0  0  0  0  0  0  0  0  0  0  0  0  99 0 0 0 0  0 0  0 0  0  0 0 4  1  7  0  0  0  0  0  0  0  0  0  0  0  0  0  99 0  0  0  0  0  0  0  0  0  0  0  99 0  0  0  0  0  0  0  0  0  0  0  0  11 12 12 12 12 12 12 12 12 12 12 12 12 12 13 1 1 1 1 1 1 1 1 1 1 1 1 1 1 1 1 1 1
0  0  0  0  0  0  0  0  0  0  0  0  0 0 0 1 1 1 1 1 1 1 1 1 1 7  0  0  0  0  0  0  0  0  0  0  0  0  0  0  0  0  0  0  0  0  0  0  0  0  0  0 0 0 0  0 0  0 0  0  0 0 4  1  7  0  0  0  0  0  0  0  0  0  0  0  0  0  0  0  0  0  0  0  0  0  0  0  0  0  0  0  0  0  0  0  0  0  0  0  0  0  0  0  0  0  0  0  0  0  0  0  0  0  0  0  0  4  1 1 1 1 1 1 1 1 1 1 1 1 1 1 1 1 1 1
0  0  0  0  0  0  0  0  0  0  0  0  0 0 0 1 1 1 1 1 1 1 1 1 1 7  0  0  0  0  0  0  0  0  0  0  0  0  0  0  0  0  0  0  0  0  0  0  0  0  0  0 0 0 0  0 0  0 0  0  0 0 4  1  7  0  0  0  0  0  0  0  0  0  0  0  0  3  3  3  0  0  0  0  0  0  0  0  0  3  3  3  0  0  0  0  0  0  0  0  0  0  0  0  0  0  0  0  0  0  0  0  0  0  0  0  0  4  1 1 1 1 1 1 1 1 1 1 1 1 1 1 1 1 1 1
0  0  0  0  0  0  0  0  0  0  0  0  0 0 0 1 1 1 1 1 1 1 1 1 1 7  0  0  0  0  0  0  0  0  0  0  0  0  0  0  0  0  0  0  0  0  0  0  0  3  3  3 0 0 0  0 0  0 0  0  0 0 4  1  7  0  99 0  99 0  0  0  99 0  0  0  0  0  0  0  0  0  0  0  0  0  0  0  0  0  0  0  0  0  0  0  0  0  99 0  0  0  0  0  0  0  0  0  0  0  0  0  0  0  0  0  0  4  1 1 1 1 1 1 1 1 1 1 1 1 1 1 1 1 1 1
0  0  0  0  0  0  0  0  0  0  0  0  0 0 0 1 1 1 1 1 1 1 1 1 1 7  0  0  0  0  0  0  0  0  0  0  0  0  0  0  0  0  0  0  0  0  0  0  0  0  0  0 0 0 0  0 0  0 0  0  0 0 4  1  7  0  0  0  0  0  0  0  0  0  0  0  0  0  0  0  0  0  0  0  0  0  0  0  0  0  0  0  0  0  0  0  0  0  0  0  0  0  0  0  0  0  0  0  0  0  0  0  0  0  0  0  0  4  1 1 1 1 1 1 1 1 1 1 1 1 1 1 1 1 1 1
0  0  0  0  0  0  0  0  0  0  0  0  0 0 0 1 1 1 1 1 1 1 1 1 1 7  0  0  0  0  0  0  0  0  0  0  0  0  0  0  99 0  0  0  0  0  0  0  0  0  0  0 0 0 0  0 0  0 0  0  0 0 4  1  7  0  99 0  99 0  0  3  3  3  0  0  0  0  0  0  0  0  0  0  0  0  0  0  0  0  0  0  0  0  0  0  0  3  3  3  0  0  0  0  0  0  0  0  0  0  0  0  0  0  0  0  0  4  1 1 1 1 1 1 1 1 1 1 1 1 1 1 1 1 1 1
0  0  0  0  0  0  0  0  0  0  0  0  0 0 0 1 1 1 1 1 1 1 1 1 1 7  0  0  0  0  0  0  0  0  0  0  0  0  0  0  0  0  0  0  0  99 0  0  0  0  0  0 0 0 0  0 0  0 0  0  0 0 4  1  7  0  0  0  0  0  0  0  0  0  0  0  0  0  0  0  0  0  0  0  0  0  0  0  0  0  0  0  0  0  0  0  0  0  0  0  0  0  0  0  99 0  99 0  99 0  99 0  99 0  0  0  0  4  1 1 1 1 1 1 1 1 1 1 1 1 1 1 1 1 1 1
0  0  0  0  0  0  0  0  0  0  0  0  0 0 0 1 1 1 1 1 1 1 1 1 1 7  0  0  0  0  0  99 0  99 0  99 0  0  0  0  0  0  0  0  0  0  0  0  0  0  0  0 0 0 0  0 0  0 0  0  0 0 4  1  9  2  2  2  2  6  0  0  0  0  0  0  0  0  0  0  0  0  0  0  0  0  0  0  0  0  0  0  0  0  0  0  0  0  0  0  0  0  0  0  0  0  0  0  0  0  0  0  0  0  0  0  0  4  1 1 1 1 1 1 1 1 1 1 1 1 1 1 1 1 1 1
0  0  0  0  0  0  0  0  0  0  0  0  0 0 0 1 1 1 1 1 1 1 1 1 1 7  0  0  0  0  0  0  0  0  0  0  0  0  0  0  0  0  0  0  3  3  3  0  0  0  0  0 0 0 0  0 0  0 0  0  0 0 4  1  1  1  1  1  1  7  0  0  0  0  0  0  0  0  0  0  0  0  0  0  0  0  0  0  0  0  0  3  3  3  0  0  0  0  0  0  0  0  0  5  2  2  2  2  2  2  2  2  2  2  2  2  2  8  1 1 1 1 1 1 1 1 1 1 1 1 1 1 1 1 1 1
0  0  0  0  0  0  0  0  0  0  0  0  0 0 0 1 1 1 1 1 1 1 1 1 1 9  2  2  2  2  2  2  2  2  2  2  6  0  0  0  0  0  0  0  0  0  0  0  0  0  0  0 0 0 0  0 0  0 0  0  0 0 11 12 12 12 12 12 12 10 0  0  0  0  0  0  0  0  0  0  0  0  0  0  0  0  99 0  0  0  0  0  0  0  0  0  0  0  0  0  0  0  0  4  1  1  1  1  1  1  1  1  1  1  1  1  1  1  1 1 1 1 1 1 1 1 1 1 1 1 1 1 1 1 1 1
0  0  0  0  0  0  0  0  0  0  0  0  0 0 0 1 1 1 1 1 1 1 1 1 1 1  1  1  1  1  1  1  1  1  1  1  7  0  0  0  0  0  0  0  0  0  0  0  0  0  0  0 0 0 0  0 0  0 0  0  0 0 0  0  0  0  0  0  0  0  0  0  0  0  0  0  0  0  0  0  0  0  0  0  0  0  0  0  0  0  0  0  0  0  0  0  0  0  0  0  0  0  0  4  1  1  1  1  1  1  1  1  1  1  1  1  1  1  1 1 1 1 1 1 1 1 1 1 1 1 1 1 1 1 1 1
0  0  0  0  0  0  0  0  0  0  0  0  0 0 0 1 1 1 1 1 1 1 1 1 1 1  1  1  1  1  1  1  1  1  1  1  7  0  0  0  0  0  0  0  0  0  0  0  0  0  0  0 0 0 0  0 0  0 0  0  0 0 0  0  0  0  0  0  0  0  0  0  0  0  0  0  0  0  0  99 0  0  0  0  0  3  3  3  0  0  0  0  0  0  0  0  0  0  0  0  0  0  0  4  1  1  1  1  1  1  1  1  1  1  1  1  1  1  1 1 1 1 1 1 1 1 1 1 1 1 1 1 1 1 1 1
0  0  0  0  0  0  0  0  0  0  0  0  0 0 0 1 1 1 1 1 1 1 1 1 1 1  1  1  1  1  1  1  1  1  1  1  7  0  0  0  0  0  0  0  0  0  0  0  0  0  0  0 0 0 0  0 0  0 0  0  0 0 0  0  0  0  0  0  0  0  0  0  0  0  0  0  0  0  0  0  0  0  0  0  0  0  0  0  0  0  0  0  0  0  0  0  0  0  0  0  0  0  0  4  1  1  1  1  1  1  1  1  1  1  1  1  1  1  1 1 1 1 1 1 1 1 1 1 1 1 1 1 1 1 1 1
0  0  0  0  0  0  0  0  0  0  0  0  0 0 0 0 0 0 0 0 0 0 0 0 0 1  1  1  1  1  1  1  1  1  1  1  7  0  0  0  0  0  0  0  0  0  0  0  0  0  0  0 0 0 0  0 0  0 0  0  0 0 0  0  0  0  0  0  0  0  0  0  0  0  0  0  0  0  3  3  3  0  0  0  0  0  0  0  0  0  0  0  0  0  0  0  0  0  0  0  0  0  0  4  1  1  1  1  1  1  1  1  1  1  1  1  1  1  1 1 1 1 1 1 1 1 1 1 1 1 1 1 1 1 1 1
0  0  0  0  0  0  0  0  0  0  0  0  0 0 0 0 0 0 0 0 0 0 0 0 0 1  1  1  1  1  1  1  1  1  1  1  7  0  0  0  0  0  0  0  0  0  0  0  0  0  0  0 0 0 99 0 99 0 99 0  0 0 0  0  0  0  0  0  0  0  0  0  0  0  0  0  0  0  0  0  0  0  0  0  0  0  0  0  0  0  0  0  0  0  0  0  0  0  0  0  0  0  0  4  1  1  1  1  1  1  1  1  1  1  1  1  1  1  1 1 1 1 1 1 1 1 1 1 1 1 1 1 1 1 1 1
0  0  0  0  0  0  0  0  0  0  0  0  0 0 0 0 0 0 0 0 0 0 0 0 0 1  1  1  1  1  1  1  1  1  1  1  7  15 16 16 16 16 16 16 16 16 16 16 16 16 17 0 0 0 0  0 0  0 0  0  0 0 0  0  0  0  0  0  0  0  0  0  0  0  0  0  15 16 16 16 16 16 16 16 16 16 16 16 16 16 16 16 16 16 16 16 16 16 16 16 16 17 4  1  1  1  1  1  1  1  1  1  1  1  1  1  1  1  1 1 1 1 1 1 1 1 1 1 1 1 1 1 1 1 1 1
0  0  0  0  0  0  0  0  0  0  0  0  0 0 0 0 0 0 0 0 0 0 0 0 0 1  1  1  1  1  1  1  1  1  1  1  9  2  2  2  2  2  2  2  2  2  2  2  2  2  2  2 2 2 2  2 2  2 2  2  2 2 2  2  2  2  2  2  2  2  2  2  2  2  2  2  2  2  2  2  2  2  2  2  2  2  2  2  2  2  2  2  2  2  2  2  2  2  2  2  2  2  2  8  1  1  1  1  1  1  1  1  1  1  1  1  1  1  1 1 1 1 1 1 1 1 1 1 1 1 1 1 1 1 1 1
1  1  1  1  1  1  1  1  1  1  1  1  1 1 1 1 1 1 1 1 1 1 1 1 1 1  1  1  1  1  1  1  1  1  1  1  1  1  1  1  1  1  1  1  1  1  1  1  1  1  1  1 1 1 1  1 1  1 1  1  1 1 1  1  1  1  1  1  1  1  1  1  1  1  1  1  1  1  1  1  1  1  1  1  1  1  1  1  1  1  1  1  1  1  1  1  1  1  1  1  1  1  1  1  1  1  1  1  1  1  1  1  1  1  1  1  1  1  1 1 1 1 1 1 1 1 1 1 1 1 1 1 1 1 1 1
1  1  1  1  1  1  1  1  1  1  1  1  1 1 1 1 1 1 1 1 1 1 1 1 1 1  1  1  1  1  1  1  1  1  1  1  1  1  1  1  1  1  1  1  1  1  1  1  1  1  1  1 1 1 1  1 1  1 1  1  1 1 1  1  1  1  1  1  1  1  1  1  1  1  1  1  1  1  1  1  1  1  1  1  1  1  1  1  1  1  1  1  1  1  1  1  1  1  1  1  1  1  1  1  1  1  1  1  1  1  1  1  1  1  1  1  1  1  1 1 1 1 1 1 1 1 1 1 1 1 1 1 1 1 1 1
1  1  1  1  1  1  1  1  1  1  1  1  1 1 1 1 1 1 1 1 1 1 1 1 1 1  1  1  1  1  1  1  1  1  1  1  1  1  1  1  1  1  1  1  1  1  1  1  1  1  1  1 1 1 1  1 1  1 1  1  1 1 1  1  1  1  1  1  1  1  1  1  1  1  1  1  1  1  1  1  1  1  1  1  1  1  1  1  1  1  1  1  1  1  1  1  1  1  1  1  1  1  1  1  1  1  1  1  1  1  1  1  1  1  1  1  1  1  1 1 1 1 1 1 1 1 1 1 1 1 1 1 1 1 1 1
1  1  1  1  1  1  1  1  1  1  1  1  1 1 1 1 1 1 1 1 1 1 1 1 1 1  1  1  1  1  1  1  1  1  1  1  1  1  1  1  1  1  1  1  1  1  1  1  1  1  1  1 1 1 1  1 1  1 1  1  1 1 1  1  1  1  1  1  1  1  1  1  1  1  1  1  1  1  1  1  1  1  1  1  1  1  1  1  1  1  1  1  1  1  1  1  1  1  1  1  1  1  1  1  1  1  1  1  1  1  1  1  1  1  1  1  1  1  1 1 1 1 1 1 1 1 1 1 1 1 1 1 1 1 1 1